anime_id,watching,completed,on_hold,dropped,plan_to_watch,total
2418,7606,190867,2365,774,111045,312657
43,11034,388141,4435,2332,173229,579171
6675,6983,229476,2188,1067,103435,343149
1698,12967,151601,10447,7940,116546,299501
759,4758,164379,1965,805,91012,262919
32937,49885,1160867,16049,12143,131941,1370885
50380,38242,108194,5921,5203,63685,221245
3002,18609,169880,12115,8224,117835,326663
19363,3982,106878,2509,1276,23520,138165
37450,90700,1179766,29877,32045,214164,1546552
513,5170,364733,2055,879,67610,440447
264,2160,101880,655,490,16252,121437
28805,8510,268697,2565,924,112421,393117
34798,35386,219496,16160,10870,156623,438535
329,13374,80568,10191,7122,123536,234791
139,2723,110997,1022,919,19555,135216
36990,1702,40781,742,301,26945,70471
44055,22000,65090,3547,4471,49331,144439
42886,1451,5833,231,144,8206,15865
22507,3013,88806,1085,713,29962,123579
23327,7371,103161,4628,2297,39140,156597
38731,11208,46864,2763,1505,17944,80284
523,11282,834705,3167,1488,114330,964972
40052,62292,301028,29661,18610,164019,575610
32188,4004,186954,1475,553,44648,237634
40784,2198,42680,658,516,10906,56958
31812,3860,115119,1440,823,56955,178197
31240,125427,1548495,43080,49306,236899,2003207
41457,60235,347219,15298,14914,166465,604131
10271,6955,118242,4184,2541,47443,179365
1033,3331,91552,1527,643,67258,164311
34036,1148,20192,411,507,5937,28195
38234,2708,126117,676,400,23889,153790
43325,22611,106633,5649,3064,68142,206099
37055,5570,166296,1834,844,69222,243766
36371,715,13603,206,326,7673,22523
11843,47162,459128,32843,21706,200840,761679
1842,1263,55559,582,595,7715,65714
37078,3511,71622,726,644,21655,98158
1735,419109,1415050,131949,146138,118602,2230848
40211,943,7793,247,193,10450,19626
5690,3194,87957,1944,1089,28962,123146
2966,36727,450165,29966,19832,226588,763278
265,1396,81851,499,395,12973,97114
18115,34427,571479,18006,13924,152199,790035
627,3295,63038,2049,1676,25489,95547
37989,9968,119614,4282,2159,39625,175648
33051,9559,89469,4015,2405,23107,128555
37520,115353,620412,48318,34989,257441,1076513
16894,30016,670428,10991,7280,68612,787327
9863,18829,81817,17416,16165,80106,214333
23847,32154,798657,12212,8980,119260,971263
11977,2778,135950,1516,1077,46390,187711
3091,4608,84972,3324,2371,39592,134867
1142,2332,65706,2092,1435,30654,102219
33674,19567,580864,6120,5954,187566,800071
15227,4631,86877,1825,763,77307,171403
38680,72952,396114,33146,27418,189578,719208
5460,958,47539,326,400,6101,55324
585,4659,235406,1869,672,75550,318156
6,38404,406925,30735,17162,194032,687258
512,5653,445851,2054,741,65103,519402
40853,416,12782,143,160,4806,18307
16664,3390,136018,1673,840,63310,205231
38249,3891,162844,913,619,25965,194232
42897,137831,763970,22447,24120,178362,1126730
558,1314,57929,606,625,7730,68204
372,1350,92066,669,465,14692,109242
35466,8527,272152,2826,2066,63498,349069
40729,19778,80754,4781,3213,71656,180182
49114,25931,107035,4893,2963,73486,214308
38003,28302,363970,11020,5020,122859,531171
45577,1602,6491,396,466,8685,17640
35838,24792,128035,13433,10485,129312,306057
19123,1415,45515,433,469,8441,56273
3226,1412,52129,664,613,7351,62169
12115,3419,170796,989,795,29030,205029
6864,2251,42558,1110,517,19262,65698
2150,2222,12890,1653,966,6374,24105
7674,30298,338129,23613,19764,175323,587127
18195,5857,94059,3693,3195,50928,157732
6811,10468,185131,6687,4315,56449,263050
32867,36775,564612,16003,8523,119479,745392
38481,22549,94027,6292,3406,82272,208546
138,2988,121019,1056,996,18998,145057
1453,5020,18177,3804,2653,36075,65729
34537,3436,54666,1185,629,52468,112384
32843,2773,14707,630,790,16821,35721
440,16190,63996,11893,6555,99737,198371
23623,9980,116441,5459,2740,52966,187586
35677,3717,55833,1346,595,59882,121373
18617,2168,68369,719,704,25648,97608
25537,7936,281131,2437,1105,117217,409826
4921,218,4839,77,139,2447,7720
39166,517,9468,221,105,9996,20307
25681,14815,273501,6910,4608,61078,360912
10800,25736,204063,19850,16015,162957,428621
22297,32219,790248,12917,8628,140755,984767
41361,1103,9588,361,138,15246,26436
37171,31942,234226,15875,15409,127750,425202
34636,24485,159918,12500,13690,92353,302946
1889,18969,298901,14009,11268,111617,454764
962,3966,33599,3052,1744,32186,74547
28171,81197,1178971,35253,40438,194854,1530713
40852,92785,590092,16392,8917,174825,883011
1519,12499,376082,7320,3736,77543,477180
30503,48384,1102621,20955,12808,170584,1355352
7791,36917,434225,26797,18915,126986,643840
35111,1718,47373,618,553,21137,71399
32005,831,30492,250,323,5668,37564
38088,1057,20325,336,296,15890,37904
9890,483,23079,204,275,4992,29033
4107,2755,108627,1420,879,39993,153674
47,12365,578088,4867,3010,166960,765290
36296,32237,277670,12465,10490,134465,467327
235,146874,6,67869,44637,61372,320758
50203,3719,9498,430,526,11014,25187
50325,1377,33519,310,170,10561,45937
50631,56043,190323,8246,5880,107291,367783
853,48933,793872,33692,31851,136134,1044482
28223,78511,1134127,45995,36136,324807,1619576
31715,2122,75456,775,541,18871,97765
28675,5574,170731,2172,928,63162,242567
239,11772,79363,10101,7327,125045,233608
35857,4235,17532,1894,1214,15521,40396
49521,372,8233,166,68,5490,14329
33486,121122,2046698,20056,18082,99388,2305346
18,8881,123331,4251,1855,24478,162796
1430,1478,86343,572,378,18529,107300
37962,3027,10774,993,752,10925,26471
11597,25213,514602,12419,7118,134560,693912
813,46054,977051,24599,29520,57397,1134621
3701,6980,47094,4866,3432,78281,140653
40421,3206,145194,951,711,53967,204029
49053,769,38460,304,331,30970,70834
232,29723,250383,25369,16846,84578,406899
12859,3922,221641,889,621,22326,249399
4477,2897,93172,2188,1300,19875,119432
1604,51391,265072,40195,40084,134897,531639
33323,1209,44470,429,245,11661,58014
1827,11808,85182,8896,5646,95060,206592
42894,917,10521,348,132,18065,29983
36946,5286,309832,667,563,28969,345317
37514,2585,57829,892,1083,44874,107263
40911,30824,174520,8984,7644,130666,352638
186,4714,158981,1811,1085,23146,189737
39792,34407,130409,18246,15674,106647,305383
2236,11790,553529,4227,2021,172639,744206
44931,1802,80214,491,200,34761,117468
40815,10818,133297,2707,2069,27378,176269
10153,594,14242,308,283,7337,22764
37430,104640,929111,25517,28462,157417,1245147
3371,973,10139,714,347,10222,22395
731,929,53059,448,362,13993,68791
36370,616,13861,212,195,6911,21795
15323,1198,54576,408,447,7570,64199
3702,6799,125112,4767,5311,58675,200664
32902,20837,151937,7092,4137,77569,261572
2581,9610,144461,6543,5038,43286,208938
40435,2839,8643,674,459,7759,20374
30831,76046,1437457,28940,31793,199459,1773695
29831,427,3940,237,204,5443,10251
6467,717,46041,280,335,5184,52557
121,64412,1046757,50056,48104,178116,1387445
39783,48813,432298,9123,7532,115014,612780
8129,7870,132372,5241,3621,71482,220586
34572,477168,466043,126273,126036,244912,1440432
721,7807,74314,7977,5845,60844,156787
25313,904,25188,450,349,11211,38102
6746,90820,752008,74063,55225,352898,1325014
35608,5244,166870,2025,1115,67196,242450
51096,83979,218676,5909,5545,86352,400461
1566,1775,62339,1003,443,29775,95335
1364,681,53303,276,325,4345,58930
39592,998,10769,419,354,6094,18634
13759,57343,814507,33651,32208,229049,1166758
4938,1358,41629,855,525,15582,59949
34076,3489,30375,1699,1087,23952,60602
6336,10824,52040,4963,2210,22444,92481
35110,1725,49910,645,569,21338,74187
4155,3294,200586,961,694,22003,227538
18689,24614,121018,15550,10797,55737,227716
3901,2254,139184,1688,997,27877,172000
40542,5449,162280,1764,1100,26558,197151
32122,732,22957,364,299,7582,31934
28025,8689,286786,3539,1481,93458,393953
23283,47128,696658,24495,20880,280964,1070125
24833,108734,1330289,69009,59968,255766,1823766
30370,8453,88066,3660,1123,22894,124196
4224,90239,1565318,53633,60528,277874,2047592
50709,64619,142883,5941,6412,93199,313054
19815,80712,1810601,35065,52509,248650,2227537
39198,16231,156763,6214,8317,86211,273736
20899,48321,939615,16784,10063,70422,1085205
42249,202333,572853,34559,43473,188238,1041456
40080,1697,29403,442,337,12510,44389
34822,28044,272756,12938,13312,167925,494975
16918,12550,151233,8850,8034,95158,275825
3927,4815,114954,2608,1676,19122,143175
12189,93662,683821,67896,53381,362748,1261508
12069,785,40743,266,288,6314,48396
4722,9127,174253,6334,7402,57340,254456
302,2021,18871,1474,967,22094,45427
2951,779,40795,456,358,10898,53286
31658,4494,220441,1065,627,42292,268919
15059,5665,92515,2392,1212,27162,128946
37822,10585,3,652,645,3526,15411
21469,779,41625,222,328,5109,48063
1382,307,5118,198,234,3468,9325
11771,61526,831515,32719,30271,151313,1107344
36456,130489,1696450,20848,18908,119590,1986285
22145,12367,279624,6250,5222,71209,374672
47904,399,6958,77,211,1517,9162
24277,7193,98935,3790,2818,17789,130525
21419,592,33707,263,305,4700,39567
40907,10417,62143,2041,1448,52183,128232
14713,24642,412407,12035,11464,133586,594134
41402,38424,145689,6522,3944,59294,253873
2025,45745,511348,37434,26610,266231,887368
35062,110963,372996,53560,42338,239946,819803
1559,15354,190911,9187,7963,61265,284680
27833,13103,236504,8199,4432,95539,357777
339,49989,298866,31593,20029,276635,677112
38081,754,18656,282,189,10487,30368
38668,30874,283633,12333,12725,133512,473077
6547,68022,1493065,42453,50165,301090,1954795
23317,5803,167335,2279,1830,51033,228280
10643,855,23083,467,384,10919,35708
1367,583,47130,263,310,4323,52609
8425,29938,256368,24194,22692,176522,509714
1471,1320,13483,718,458,8466,24445
851,2123,11425,1266,765,15190,30769
21557,4594,187771,1841,825,71843,266874
